# # # # # # # 
#         n #     
#           # 
#  b b      # 
# # #  0# # # 
-
0:12 10 1
