# # # # # # # # # # # #
#           #         # 
#                     #
#           #         # 
# # #  0# # # # #  0# # 
-
0:15 6 3
1:18 6 3
