# # # # # # # 
#           #     
#           # 
#           # 
# # #  0# # # 
-
0:24 6 1
